"_____xx****S"
"_____xx*____"
"_____xx*____"
"********____"
"*____xx_____"
"*____xx_____"
"F____xx_____"