"F*****__"
"____x*_x"
"___x**x_"
"__x_*x__"
"__x_*x__"
"___x**x_"
"____x**x"
"_____x*S"