"S__xx__xxx"
"***xx__xx_"
"xx*_x__x__"
"_**____x__"
"_*xx__x___"
"_**___x_x_"
"xx*__xx__x"
"F**_"